-------------
-------------
--------#----
------###----
-------------
----#--------
----##-----=-
-------------