--#-------=--
--#----------
--------##---
--#----------
-------#-----
---##--#-----
----#--------
-------------