-------------
--#-----#----
--#-----#--=-
-------------
------##-----
-----------#-
--###------#-
----------##-