-------------
-----#---#---
-----#-###---
--#----------
--#---##---=-
-------------
----##-------
-------------